111111
100001
101001
100001
111111