111111111111111
1PCCCCCCCCCCCC1
1CCCCCCCCCCCCC1
1CCCCCCCCCCCCC1
1CCCCCCCCCCCCC1
1CCCCCCCCCCCCC1
1CCCCCCCCECCCC1
1CCCCCCCCCCCCC1
1CCCCCCCCCCCCC1
111111111111111