1111111111
1000000001
1000000001
1000000001
1000000001
100E000001
1001111001
1010C00101
1001111001
1000000001
1000P00001
1000000001
1000000001
1000000001
1000000001
1000000001
1111111111

