
11111111111111111111111111111111111
1P0000000000000000000000000000000E1
10111111111111111111111111111111001
10C00000000000000000000000000000101
101011111111101111111111C1111110101
10101000000100100000000000000100101
101010111C011110111111111C110110101
10101010000100001000000000100100101
10101010111101111101111110110110101
10101010000001000C01000000100100101
10101111111111111111111111110110101
10100000000000000000000000000100101
10101111111111111111111111111110101
101000000000C0000000000000000000011
10111111111111111111111111111111001
10000000000000000000000000000000001
10111111111111111111111111111111001
1C0000000000000000000000000000000C1
11111111111111111111111111111111111