1111111111
1P000000C1
1000000001
1000E00001
1000000001
1111111111