11111111111111111
10000000000000001
1000P0000C0000001
10000000000000001
1000000E000000001
10000000000000001
11111111111111111


