1111111111
1000100001
1001PC1001
1000100001
1100000111
1001C11E01
1111111111