1111111111111111111111111111111111
100000000000000C00000C000000000001
1010010100100000101001000000010101
1010010010101010001001000000010101
100000000C00C0000000000000000000C1
1000000000000000000000000000000001
1000000000100000E00000000000010001
10000000000100C0000000000010000001
100000C000001000000000000100000001
1000000000000001000000000100000001
1000000000000000000000C00000000001
1P00000000000000000010000100000011
1111111111111111111111111111111111
