1111111111111111111
1P00000000000000001
1000CC00000CC000001
100CCCC000CCCC00001
100CCCCC0CCCCC00001
100CCCCCCCCCCC00001
1000CCCCCCCCC000001
10000CCCCCCC0000001
100000CCCCC00000001
1000000CCC000000001
10000000C0000000001
10000000E0000000001
1111111111111111111
