11111111111111111111
1P000000000011111111
111101111110C0000001
10000100000011111001
10111101111110001001
10100000000110101001
10101111110100101101
10101000010100100001
10101011110111101111
10001010000100000001
11111011110101111101
10000000000101000001
10111111111101111001
10100000000000001001
10101111111111111001
10000000010000000001
11111110111111111111
10000000000000000001
1E111110111111111111
11111111111111111111