11111111111111111111
1P000000000110000001
11101111101110111101
100000000C0001000001
10111111101011111011
10000000010000000001
10111110111111111011
10000100000000001001
11110101111111011011
1000010000C000001001
10111111111111111011
10000000000100000001
11111111110111111011
10000000000100001001
10111111110101111011
100000000001000010C1
10111111111111111101
100000000000000000E1
10111111110111111111
1C00000000C0000000C1
11111111111111111111